0000000000
0000040000
0000440000
0444444444
0044444400
0044004400
0040000400